111111111111111111111111111111111111111111111111111
10C00000000000000001C00E1E00000000000000000000000C1
100000000000100000010000011111100000000000000000001
100000000000100000011111010000000000111111011111111
1000111111111000000000000100000000001CC00E000000CC1
10000000000C100000000000010000000000100000000000001
111111111111100000000000010000000000100000000000001
100000000000000000000000010000000000100001000100001
1000011111111100000000000100000000001CC001000100CC1
10001C000000000100000000010000000000111111000111111
1000100000000001000000000100000000000000100011111C1
100010C00000000100000000010000000000000010011000001
10001111111111110P000000011000000000000100110000001
100000000000000000000000010000000000001001100000001
100000000000000000111101001000000000010011000000001
111001111111111000000100100100000000100110000000001
1000000000E10C1000001000010011111111100110000000001
111111110001001000010000001000000000001100000000001
1C000C0100C1001000100000000111111111111000000000001
100000011111001111000000000000000000000000000000001
100000000000000000000000000000000000000000000000001
100000000000000000000000000000000000000000000000001
1000000000000000C1010000000000000000000000000000001
1000000000000000010100000000C0000000000000000000001
100000000000000001C100000000000000000000000000000C1
10000000C000000001111100000000000000000000000000001
1000000000000000000000000000000000000000000000000E1
111111111111111111111111111111111111111111111111111
