1111111111111111111111111111111111
1E0000000C000010000000100000000111
1110101010010000000000100000001111
101C010010101010001101000010010111
1P000000000000000E0000000010000011
1111100111C11111111111111101111111
1111111111111111111111111111111111
