11111111111111111111111111111111111111111111111111
101E101010101C1E1010100C100010101E0011C10101100C01
100000C0000010000001001110110000010C01000100001111
1C1001000011E0P11100000010000011110111000110000111
111110001010101C0000C000000000C1000000100001001011
10100011011001100110011001100111011001100110011001
100000011001100111000C0001000000000000000000000101
1C10010000110011EC00000010000000000111000110000001
111000001000101C1100C000010000C1000000000001001C11
10000011011000000000011001100111011001100110011001
1CC1100110011C0111000C00010000000E10000000000E11C1
101E101010101C1E1010100C100010101E0011C10101100C01
100000C0000010000001001110110000010C01000100001111
1C1001000011E0111100000010000011110111000110000111
111110001010101C0000C000000000C1000000100001001011
10100011011001100110011001100111011001100110011001
100000011001100111000C0001000000000000000000000101
1C10010000110011EC00000010000000000111000110000001
111000001000101C1100C000010000C1000000000001001C11
10000011011000000000011001100111011001100110011001
1CC1100110011C0111000C00010000000E10000000000E11C1
101E101010101C1E1010100C100010101E0011C10101100C01
100000C0000010000001001110110000010C01000100001111
1C1001000011E0111100000010000011110111000110000111
111110001010101C0000C000000000C1000000100001001011
10100011011001100110011001100111011001100110011001
100000011001100111000C0001000000000000000000000101
1C10010000110011EC00000010000000000111000110000001
111000001000101C1100C000010000C1000000000001001C11
10000011011000000000011001100111011001100110011001
1CC1100110011C0111000C00010000000E10000000000E11C1
101E101010101C1E1010100C100010101E0011C10101100C01
100000C0000010000001001110110000010C01000100001111
1C1001000011E0111100000010000011110111000110000111
111110001010101C0000C000000000C1000000100001001011
10100011011001100110011001100111011001100110011001
100000011001100111000C0001000000000000000000000101
1C10010000110011EC00000010000000000111000110000001
111000001000101C1100C000010000C1000000000001001C11
10000011011000000000011001100111011001100110011001
1CC1100110011C0111000C00010000000E10000000000E11C1
101E101010101C1E1010100C100010101E0011C10101100C01
100000C0000010000001001110110000010C01000100001111
1C1001000011E0111100000010000011110111000110000111
111110001010101C0000C000000000C1000000100001001011
10100011011001100110011001100111011001100110011001
100000011001100111000C0001000000000000000000000101
1C10010000110011EC00000010000000000111000110000001
111000001000101C1100C000010000C1000000000001001C11
10000011011000000000011001100111011001100110011001
1CC1100110011C0111000C00010000000E10000000000E11C1
101E101010101C1E1010100C100010101E0011C10101100C01
100000C0000010000001001110110000010C01000100001111
1C1001000011E0111100000010000011110111000110000111
111110001010101C0000C000000000C1000000100001001011
10100011011001100110011001100111011001100110011001
100000011001100111000C0001000000000000000000000101
1C10010000110011EC00000010000000000111000110000001
111000001000101C1100C000010000C1000000000001001C11
10000011011000000000011001100111011001100110011001
1CC1100110011C0111000C00010000000E10000000000E11C1
101E101010101C1E1010100C100010101E0011C10101100C01
100000C0000010000001001110110000010C01000100001111
1C1001000011E0111100000010000011110111000110000111
111110001010101C0000C000000000C1000000100001001011
10100011011001100110011001100111011001100110011001
100000011001100111000C0001000000000000000000000101
1C10010000110011EC00000010000000000111000110000001
111000001000101C1100C000010000C1000000000001001C11
10000011011000000000011001100111011001100110011001
1CC1100110011C0111000C00010000000E10000000000E11C1
1C10010000110011EC00000010000000000111000110000001
111000001000101C1100C000010000C1000000000001001C11
10000011011000000000011001100111011001100110011001
1CC1100110011C0111000C00010000000E10000000000E11C1
11111111111111111111111111111111111111111111111111
