1111111111111111111111111111111111
1E00000000C00000000000010000000001
1110101010010000000000100000001001
101C010010101010001P01000010010101
10000000000000000E0000000010000011
1111100111C11111111111111101111111
1111111111111111111111111111111111
