111111111111111
1C00000000000C1
100000E00000001
10E000100000001
100000100000001
100000100001111
1P00001C00000E1
111111111111111
