1111111111111111111111111111111
1E000000000000EC00000C000000001
1011C1C10010000E101001000000011
1111111111100111111111110111111
1E000000000000EC00000C000000001
1E0000P00000000C00000C000000001
1010010100000000101001000000011
1111111111111111111111111111111
