11111111111111111111111111111111111111111111111
10100101001000001010010000000101000110000101001
1000000000101010E010010000000101000010000101001
1P000000EC00C0000000000000000000C10010100101001
11010011111110011100000111111001110110100101001
11111111111100011110000000000111110100100101001
100000000000000C0000011000000000010000000000001
100000000001C0000000100000000011C01000000000111
11111111111110011100000000000111111110000001011
11111111111111111111111111111111111111111111111
