1111111111111111111111111111111111
11000000000000000000000C0000000001
1010010100100000000001000000010101
1010010010101010001P01000000010101
10000000000000000E0000000000000001
1111111111111111111111111111111111
1111111111111111111111111111111111
