1111111111111
1111000000111
111111PC00011
1111111111111
1111111111111
1111000000111
1111110000111
1111111111111
1111111111111
1111111111111
1111111111111
1111111111111
1111111111111
